Red door = CCC
Green door = DDD
Blue door = EEE
Dragon = X
Player = P
Treasure = T
Red key = R
Green key = G
Blue key = B

Objects longer than 1 character have coordinates that are based off of the upper left most LED point

		"################################################################" 0
		"#                                                              #"
		"#                                                              #"
		"#        P                                                     #"
		"#                                                              #"
		"#                                                              #"
		"#                                                              #"
		"################                                               #" 7
		"#              #                                               #"
		"#      TTT     #                                               #" T(7,9)
		"#      TTT     #                                               #"
		"#              #                                               #"
		"######EEE#######                   #############################" doorB(6,12)
		"#                                                              #"
		"#                                                              #"
		"#                                                              #" 15
		"#                                                              #"
		"#                                               R              #"
		"#                                                              #"
		"#                                                              #"
		"#                                                              #"
		"#                                                              #"
		"#                                                              #"
		"################################                               #" 23
		"#                                                              #"
		"#                                                              #"
		"#                                                              #"
		"#                                                              #"
		"#                                                              #"
		"#                                                              #"
		"#                  XX                                          #" dragon(10,30)
		"#                  XX                                          #" 31
		"#                                                              #"
		"#                                          #####################"
		"#                                          #                   #"
		"#                                          #                   #"
		"#                                          D                   #" doorG(43,36)
		"#                                          D                   #"
		"#                                          D        B          #"
		"#                                          #                   #" 39
		"#                                          #                   #"
		"#                                          #####################"
		"#                                                              #"
		"#                                                              #"
		"#                                                              #"
		"#                                                              #"
		"#                                                              #"
		"#                                                              #" 47
		"#                                                              #"
		"#                                                              #"
		"#                                                              #"
		"#                                ###########CCC#################" doorR(44,51)
		"#                                #                             #"
		"#                                #                             #"
		"#                                #                             #"
		"#                                #                             #" 55
		"#                                #             G               #"
		"#                                #                             #"
		"#                                #                             #"
		"#                                #                             #"
		"#                                #                             #"
		"#                                #                             #"
		"#                                #                             #"
		"################################################################" 63